Dorloter - Skjemme bort
Faire main basse - Legge beslag på
Excédé - Oppbrakt
Reddition - Overgivelse
Lézarder - Sprekke
Astiquer - Polere
Chambranle - Dørkarm 
Démener - Slite med
Gibet - Galge
Bleûté - Aristokratisk
Promouvoir - Forfremme
Siroter - Nippe til
Gond - Hengsel
Broc - Mugge
Baudet - Esel
Pansu - Lubben
Avachi - Tam, slapp
Autarcie - Selvhjulpenhet
Étron - Bæsj
Charpie - Lo
Âcre - Etsende
Cornichon - Sylteagurk
Palabrer - Småprate
Tôle - Metall
Sommier - Fjær madrass
Gigoter - Vri seg
Stère - Mål av stabel
Affluent - Side elv
Tonitruant - Rumlende
Rêche - Slitt
Place balnéaire - Resort
Gourdin - Politi kølle
Vis - Skrue
Besace - Bag
Démettre - Forflytte
Parér - Pynte
Draguer - Flirte, skrape bunn
Reddition - Overgivelse
Étau - Skrustykke
Taupe - Muldvarp (spion)
Peaufiner - Gjøre klar
Ouïe - Hørsel
Roussi - Utbrent
Ciller - Blunke
Matraque - Batong
Transi - Kulde sjokk
Bourrade - Dytt
Dégringoler - Falle ned
