Les Bienveillantes II

Piétiner - Trampe på
Exsangue - Blodfattig
Hope - Krus
Gausser - Gjøre narr av 
Serre - Drivhus
Goguenard - Hånende
Éstropié - Forkrøplet
Larger - Slippe ut
Éclopé - Handicappet
Empailler - Stoppe ut
Canotier - Båtmann
Ingérence - Innblanding
Égaré - Fortumlet
Débile - Tilbakestående
Engelure - Frostbitt
Vendre la mèche - Sladre
Infect - Motbydelig
Fumiste - Pipefeier
Four - Ovn
Inné - Medfødt
Poisse - Klissete
Effaré - Engstelig
Épancher - Fortro seg
Plastron - Brystplate
Amidonner - Stivelse
Mégère - Spissmus
Panse - Hengemage
Grelotter - Skjelve
Engourdir - Nummen
En deça de - På denne siden av
Tripoter - Fikle med
Argutie - Vittighet
Entraide - Gjensidig help
Flasque - Lubben
Vrac - Hulter til Butler
Abroger - Oppheve
Couperet - Kjøttsaks
Débandade - Løpe i panikk
Débiter - Kutte opp
À même le - Samtidig
Gamelle - Nisteboks
Rassasier - Mette
Atrophié - Forvitret
Nocif - Skadelig
Escabeau - Krakk
Ramper - Kravle
Assiéger - Omringe
Exigu - Liten 
En sus de - I tillegg til
Étriper - Skjære ut innvollene
Récuser - Utfordre
Inanité - Forfengelighet
Arriération - Stagnasjon
Éffrené - Vill og uregjerlig 
Gadoue - Gjørme
Moignon - Stump
Douille - Patronhylse
Parvenir - Nå
Combles - Loft
Hérisson - Pinnsvin
Meurtri - Såret
Reflux - Strøm i havet 
Faste - Strålende
Otarie - Sjøløve
Assise - Kurs
Étain - Tinn
Mousser - Skumme
Choir - Falle
Manivelle - Sveiv





