Tambour - Svingdør 
Hélice - Propell     
Tire au Cordeau -  Rett som en snor 
Désalterer - Slukke tørsten 
Trapu - Kortvokst
Carlingue - Kabin
Clef a molette - Skiftnøkkel
Cales - Hengetrapp     
Soute - Flydør
Béquilles - Krykker
Impavides - Uberørt
Embardée - Skrens
Congères - Snøfonn        
Endiguer - Stage, bremse      
Rusé - Listig         
Reaper - Fikse, lappe på
Fêlé - Sprukket
Fluet - Slank
Pommette - Kinneben
Fiable - Til å stole på
Carrier - Bære med seg (om is på elv)          
Carburant - Drivstoff            
Relever - Besvare, reagere på
Démangeaison - Trengende behov, kløe
Ferroviaire - Jernbane relatert
Haillons - Filler
Étayer - Fundamentert på
Troglodyte - Huleboer
Billot - Blokk
Équarrisser - Slakte       
Joncher - Forsøple
Mortier - Segment
Arborer - Holde oppreist
Damier - Spillbrett (Checkers)          
Fer-blanc - Hermetikk books
Prolixe - Snakkesalig
Ralenti - Sakte film
Soupirail - Kjeller vindu           
Accrochage - Clash, kamp
Biberon - Tåteflaske
Débraillé - Ustelt         
Borné - Trangsynt
Lampée - Gulp
Interloqué - Sjokkert
Pot - Mugge, books
Côtoyer - Være skulder til skulder
Préalable - Innledende
Anicroche - Problem
Caller - Stoppe opp (motor)
Équitable - Rettferdig
Capoter - Forpurre
Pelée - Bar, glatt
Baliser - Fyrtårnaktig
Galet - Liten rund sten
Barrage - Demning, kryssild
Millet - Hirse
Assigner - Øremerke
Meneur - Leder
Contrefort - Dalside
Butin - Tyvegods
Échouer - File, ended opp
Cafouillage - Stry
  




