Rédimer - Lønne seg
Futé - Smart
Mèprendre - Misforstå
Mouiller - Fukte
Préconiser - Snakke varmt om 
Désagréger - Bryte i stykker 
Bafouer - Trampe på
Démesure - Overdrivelse
Beffroi - Klokketårn
Fanion - Vimpel
Aviné - Beruset
Malversation - Mislighold, underslag
Agape - Flott måltid
Lésiner - Spare på
Maquette - Prototype, modell
Gigoter - Sprelle
Mielleux - Slesk
Rebrousser - Snu
Carence - Knapphet
Pare-choc - Skjerm
Tétras - Rype
Miette - Smule
Glapir - Klynke
Escadrille - Skvadron
Roulement à bille - Kulelager
Asperger - Spraye
Mugir - Drønne
Canalisation - Rørledning
Bondé - Stappfull
Sinistré - Ullykkesoffer
Lorgner - Stirre på
Indemne - Uskadet
Abîmé - Ødelagt
Poussette - Barnevogn
Pallier - Overkomme
Troquer - Bytte
Astucieux - Smart
Pécuniaire - Finansiell
Débit - Debit, output
Fusée - Rakett
Châlit - Seng
Dépenaillé - Falleferdig, skrøpelig
Chouette - Ugle
Moquette - Teppe
Évier - Vaskekum
Étalon - Avlshingst
Piètre - Dårlig, ussel
Préconiser - Foreslå
Rechange - Alternativ
Vicié - Forsøplet

