Ratiociner - Resonnere logisk
Boursier - Stipendiat
Leste - Smidig
Crâner - Tøffe seg
Épater - Imponere
Vendange - Drue innhøsting
Oripeaux - Stoff (tøy)
Broutille - Bagatell 
Poisseux - Klistrete
Rapetisser - Gjøre mindre
Vestiaire - Garderobe
Crique - Bukt
Dégourdi - Smart
Affectation - Stilling
Opuscule - Brosjyre
Prélever - Trekke fra
Artisanal - Håndtverker
Chipoter - Være tvetydig
Pallier - Lindre
Main d'œuvre - Arbeidskraft
Jérémiade - Syting
Lénifiant - Smakelig
Bedaine - Vom
Galeux - Skitne
Peiner - Jobbe hardt
Glousser - Fnise
Laiton - Messing
Devise - Motto, penger
Fripes - Brukte klær
Mirador - Vakt tårn
Bondé - Fullstappet
Surnager - Flyte
Beuverie - Drukkenskap
Cerf - Rådyr
Braconnier - Tyvjeger
Déboire - Uhell, problem
Dépecer - Kutte ved ledd
Choper - Ta på fersken
Épluchure - Skall, skrell
Rayé - Stripete
Pinède - Furuskog
Espiègle - Leken
Rembourrage - Stoff fyll
Gambader - Gå fort
Faisandé - Smak av vilt
Rendement - Produktivitet
Pis - Verst
Muter - Forflytte
Criaillerie - Klaging
Calendes - Første dagen i måneden
Lèser - Skade
Échantillon - Mønster, prøve
Dénicher - Skaffe